0001111000011101
1011010101010101
0000011001010101
0110111101010101
0011011001010100
0010110101010101
0101010101110111
1001010100011110
0111010101011111
